5 13 31
###############################
#p * *3       *  ** * *      *#
# # # # #*# # #*#     # # #*# #
#    * * *** **      *    **  #
# #*# # # # #4# #bx1  # # # #*#
#          *     **      *  **#
# # #*# 7 # # # #*#*#*#*# # # #
#   *        *   * *x* *   4  #
# # # # #*# 6 # # # # #*# #*# #
#   ****         *2           #
# # # # # # # # # #*# # # # #*#
#  ** *5  *                   #
###############################