2 13 31
###############################
#p * *2       *  s* * *      *#
# # # # #*# # #*# # # # # #*# #
#    * * *m* f*      *    f*  #
# #*# # # # #1# #b#1# # # # #*#
#          *     **      *  *s#
# # #*# # # # # #*#*#*#*# # # #
#   * 3      *   * *x* *      #
# # # # #*# # # # # # #*# #*# #
#   x*m*  7      *1           #
# # # # # # # # # #*# # # # #f#
#  f* *   *    2              #
###############################